1111111
1000E01
1C000P1
1111111