1111111111111
1001000C00001
1000001111001
10C011EPC0001
1111111111111