1111111111111
100100C0M00C1
100000MC00001
1000C11110001
1P0011E00C001
100000MC00001
1000C11110001
100000MC00001
1000C11110001
100000MC00001
1000C11110001
100000MC00001
1111111111111