1111111111111
100100C00M0C1
1000011111001
1P0011E00C001
1111111111111