1111111111111111111111111111111111
1E0000000000000C00000C000000000001
1010010100100000101001000000010101
1010010010101010001001000100010101
1P0000000C00C000M000000001000000C1
100001000000000C00000C000100010001
1010010100100000101001000100010101
1010010010101010001001000100010101
100000001C10C0000000000000000100C1
1111111111111111111111111111111111