1111111111111111111111111111111111
1E0000000000M00C0000MC000000M00001
1010010100100000101001000000010101
101M010010101010001001000100010101
1P0000000C00C00000M0000010000000C1
10000100000000MC00000C0M0100010001
101001010010000010100100010C010101
101001001010101000100100010M010101
100000001C10C000M0000C000C000100C1
1111111111111111111111111111111111