111111111111111111111111111111111111
1MC000MC101010001000100010001100M0C1
10101000100010C010101010101010010101
10P010100010101010100010100010000001
101010100010M01010101010C01000101001
10101000CM101010001000101010C0101011
101010101010101010100010101011C10101
10001010001010100C0000C010101000M001
101010101010101010100010100001010101
10101010000010C00C0M0C10101001000101
1010C0101010101010100010001001010C01
10101010C010101000001C10101010010101
1010101010100010101C100C00100C0101E1
111111111111111111111111111111111111