111111111111111111111111111111111111
1M0000MC101010001000100010001100M0C1
10101000100010C010101010101010010101
10P010100010101010100010100010000001
101010100010M01010101010C01000101001
10101000CM101010001000101010C0101011
101010101010101010100010101011C10101
10001010001010100000100010101000M001
101010101010101010100010100001010101
1010101000001000000M1010101001000101
1010C0101010101010100010001001010C01
10101010C010101000001010101010010101
1010101010100010101C100C0010000101E1
111111111111111111111111111111111111