1111111111111
100100C0000C1
1000000C00001
1000C11110001
1P0011000C001
100000C000001
1000C11110001
1000000C00001
1000C11110001
1000000C00001
1000C11110001
100C00M00M0E1
1111111111111