11111111111111111111
1C0000C0000100C000C1
10011111C01000001011
1000C1C0001110C110C1
10011111C01C0001C011
100000C0001110C110C1
10000111C01C0001C011
1P0011E00C000C0000C1
11111111111111111111